+--------------+
||            ||
||  WWWWWWWW  ||
||        WW  ||
||  WW        ||
||  WWWWWWWW  ||
||            ||
+--------------+